101 101 150 100
11111111111111111111111111111111111111111111111111111111111111111111111111111111111111111111111111111
10000000000000000000000000000000000000000000000000000000000000000000000000000000000000000000000000001
10000000000000000000000000000110000000000000000000000000000000000000001100000000000000000000000000001
10000011111110000000000000000110000000000000000000000000000000000000001100000000000000001111111000001
10000010000010000000000000000110000000000000000000000000000000000000001100000000000000001000001000001
10000010010010001111100000000110000000111110000000000000001111100000001100000000111110001001001000001
10000010010010000010000111100000000100100010001010001010001000100100000000111100001000001001001000001
10000010010010000010000100000000000100100010001010001010001000100100000000000100001000001001001000001
10000010010010000010000100000000000100100010001010001010001000100100000000000100001000001001001000001
10000010010010000010000100001111000100100010001010001010001000100100011110000100001000001001001000001
10000010010010000010000100001111000100100010001010001010001000100100011110000100001000001001001000001
10000010011110001111100100001111000100100010001010001010001000100100011110000100111110001111001000001
10000010000000000000000100001111000100100010001010001010001000100100011110000100000000000000001000001
10000011111111111111111100001111000111100011111010001011111000111100011110000111111111111111111000001
10000000000000000000000000001111000000000000000010001000000000000000011110000000000000000000000000001
10000000000000000000000000001111000000000000000010001000000000000000011110000000000000000000000000001
10001110000000000000000000000000000000000000000010001000000000000000000000000000000000000000001110001
10001110000000000000000000000000000000000000000010001000000000000000000000000000000000000000001110001
10001110000011111111111111111111111111111111111110001111111111111111111111111111111111111000001110001
10001110000000000000000000000000000000000000000000000000000000000000000000000000000000000000001110001
10001110000000000000000000000000000000000000000000000000000000000000000000000000000000000000001110001
10001110000000000000000000000000000000000000000000000000000000000000000000000000000000000000001110001
10001110000100001000100010001000100011111111111110001111111111111000100010001000100010000100001110001
10000000000100001000100010001000100010000000000010001000000000001000100010001000100010000100000000001
10000000000100111001100111001000100010000000000010001000000000001000100010011100110011100100000000001
10000000000100001000100010001000100010011111110010001001111111001000100010001000100010000100000000001
10000000000100001000100010001000100010011111110010001001111111001000100010001000100010000100000000001
10000000000100001000110010011100100010011111110010001001111111001000100111001001100010000100000000001
10000000000111001100100010001000100010000000000010001000000000001000100010001000100110011100000000001
10000000000100001000100010001000100010000000000010001000000000001000100010001000100010000100000000001
10001110000100001000100111001000100010000000000010001000000000001000100010011100100010000100001110001
10001110000100001000100010001000100010011111111110001111111111001000100010001000100010000100001110001
10001110000100001000100010001000100010010000000000000000000001001000100010001000100010000100001110001
10001110000100111100110010011100100010010000000000000000000001001000100111001001100111100100001110001
10001110111100001000100010001000100010010001111000000011110001001000100010001000100010000111101110001
10001110000000000000100010001000100010010001111000000011110001001000100010001000100000000000001110001
10001110000000000000100010001000100010010001111000000011110001001000100010001000100000000000001110001
10001110000000000000100111001000100010010001111000000011110001001000100010011100100000000000001110001
10001110000000000000100010001000100010010001111000000011110001001000100010001000100000000000001110001
10000000001111110000100010001000100010010001111000000011110001001000100010001000100001111110000000001
10000000001000010000110010011100100010010000000000000000000001001000100111001001100001000010000000001
10000000001000010000100010001000100010010000000000000000000001001000100010001000100001000010000000001
10000000001000010000100010001000100010011111111110001111111111001000100010001000100001000010000000001
10000111111000010000000000000000100000000000000010001000000000000000100000000000000001000011111100001
10000100000000010000000000000000100000000000000010001000000000000000100000000000000001000000000100001
10000100000000010000000000000000100000000000000010001000000000000000100000000000000001000000000100001
10000100000000011111111111111111100000000000000010001000000000000000111111111111111111000000000100001
10000100000000000000000000000000000010000000011110001111000000001000000000000000000000000000000100001
10000100000000000000000000000000000010011110010000000001001111001000000000000000000000000000000100001
10000100001100000000000000000000000010011110010000000001001111001000000000000000000000000110000100001
10000000001100011111000000111111110010011110010000000001001111001001111111100000011111000110000000001
10000000001100010000000000000000010010011110010000000001001111001001000000000000000001000110000000001
10000000001100010000000000000000010010011110010000000001001111001001000000000000000001000110000000001
10000000001100010001111111111110010010011110010000000001001111001001001111111111110001000110000000001
10000000001100010001111111111110010010011110011110001111001111001001001111111111110001000110000000001
10000000001100010001111111111110010010011110000010001000001111001001001111111111110001000110000000001
10000000001100010001000000000000010010011110000010001000001111001001000000000000010001000110000000001
10000100001100010001000000000000010010011110000010001000001111001001000000000000010001000110000100001
10000100001100010001111111111111110010011110010010001001001111001001111111111111110001000110000100001
10000100001100010000000000000000000010011110010010001001001111001000000000000000000001000110000100001
10000100001100010000000000000000000010011110010010001001001111001000000000000000000001000110000100001
10000100000000011111111111111111111110011110010010001001001111001111111111111111111111000000000100001
10000100000000000000000000000000000000000000010010001001000000000000000000000000000000000000000100001
10000100000000000000000000000000000000000000010010001001000000000000000000000000000000000000000100001
10000100011111110000000000000000011111111111110010001001111111111111000000000000000001111111000100001
10000100011111110000010001000000011111111111110010001001111111111111000000010001000001111111000100001
10000100011111110000010001000000011111111111110010001001111111111111000000010001000001111111000100001
10000000011111110000010001000000000000000000000000000000000000000000000000010001000001111111000000001
10000000011111110000010001000000000000000000000000000000000000000000000000010001000001111111000000001
10000000011111110000010001111111111111111111111110001111111111111111111111110001000001111111000000001
10000000011111110000010000000000000000000000000000000000000000000000000000000001000001111111000000001
10000000011111110000010000000000000000000000000000000000000000000000000000000001000001111111000000001
10000000011111110000010000000000000000000000000000000000000000000000000000000001000001111111000000001
10000100011111110000011111111111111111111111111100000111111111111111111111111111000001111111000100001
10000100000000000000000000000000000000000000000100000100000000000000000000000000000000000000000100001
10000100000000000000000000000000000000000000000100000100000000000000000000000000000000000000000100001
10000100000010000010000011111100000111111000000100000100000011111100000111111000001000001000000100001
10000100000010000010000010000100000100000000000100000100000000000100000100001000001000001000000100001
10000100000010000010000010000100000100000000000100000100000000000100000100001000001000001000000100001
10000100000010000010000010000100000100000000000100000100000000000100000100001000001000001000000100001
10000100000010000010000010000100000100000000000100000100000000000100000100001000001000001000000100001
10000111111110000011111110000111111100001111111100000111111110000111111100001111111000001111111100001
10000000000000000000000000000000000000000000000000000000000000000000000000000000000000000000000000001
10000000000000000000000000000000000000000000000000000000000000000000000000000000000000000000000000001
10000000000000000000000000000000000000000000000000000000000000000000000000000000000000000000000000001
10000000000000000000000000000000000000000000000111111100000000000000000000000000000000000000000000001
10000000011111100000111111110000011111111000000111111100000011111111000001111111100000111111000000001
10001100011111100000111111110000011111111000000111111100000011111111000001111111100000111111000110001
10001100011111100100111111110010011111111001000111111100010011111111001001111111100100111111000110001
10001100011111100100111111110010011111111001000111111100010011111111001001111111100100111111000110001
10001100011111100100111111110010011111111001000111111100010011111111001001111111100100111111000110001
10001100011111100100111111110010011111111001000111111100010011111111001001111111100100111111000110001
10001100011111100100111111110010011111111001000111111100010011111111001001111111100100111111000110001
10001100011111100100111111110010011111111001000111111100010011111111001001111111100100111111000110001
10001100011111100100111111110010011111111001000111111100010011111111001001111111100100111111000110001
10001100011111100100111111110010011111111001000111111100010011111111001001111111100100111111000110001
10001100011111100100111111110010011111111001000111111100010011111111001001111111100100111111000110001
10001100011111100000111111110000011111111000000111111100000011111111000001111111100000111111000110001
10000000011111100000111111110000011111111000000111111100000011111111000001111111100000111111000000001
10000000000000000000000000000000000000000000000000000000000000000000000000000000000000000000000000001
11111111111111111111111111111111111111111111111111111111111111111111111111111111111111111111111111111